 ####################################
 ####################################
 ##E#           #                  ##
 ## # ######### # ##### # ##### ## ##
 ## #     #     # #     #        # ##
 ## ### # # ####### #############  ##
 ##     # #       #                ##
 ######## ####### # # ### #      # ##
 ##       #       #              # ##
 ## ####### ################### ## ##
 ##         #   #       #       #  ##
 ## ######### # # # ### # #######  ##
 ##       #   # # # #   # #   #    ##
 ###### # ### # # # # ### # ### #  ##
 ## #   #     # # # #     # #   #  ##
 ## # # ####### ### ####### # ###  ##
 ##   #       #   # #         # #  ##
 ## ####### ##### # # ######### ## ##
 ## #     #     # # #         #    ##
 ## # ### # # # # # ######### ###  ##
 ##   #   #   #     #             S##
 ####################################
 ####################################